MAP: 5 5
o x o x o
o o o o o
o o o o o
x x o o o
x o o o x